6 6 5 4 5
5 5 4 4 5
4 5 2 3 3
5 5 4 3 4
4 4 5 4 3
